12 6
...B.....A..
...3........
#####.......
.......#####
........C...
....1..2....