18 7
..................
...A...B........4.
..................
.#############...D
..............###C
.................#
....1...2.....3...