8 5
.B....A.
........
..####..
.1.#..2.
........
